1111111111111111111111111111111111
100000X010000000000000000000000001
10P00000100000000000000000C0000001
1000000010000001111111111111111111
10000C0000000000000000000000000001
10000000000000X0000000000000000001
1111111111111111000000001000000001
100000000C000000000000001000000001
10000000000000000000X0001000000001
1000111111110000000C00001000000001
100000X000000000000000000000000001
10000000000000111111100000000C0001
10000001100000000X0001111111111111
1000000C10000000000001000100000E01
1000000010000000000000010001000001
1111111111111111111111111111111111