1111111111
100P000001
1111111101
1C0000C001
1111111111
100C000E01
1111111111