1111111111
100P000001
1111111101
1C0000C001
1011111111
100C000EC1
1111111111