1111111111111111
1X0P000000000001
1111111101111111
1C0000C0000000X1
1011111111110111
100C00X0E000C001
1111111111111111