1111111111111111
1P00000010000001
1101111010111101
11111C10101C1101
1100001010100001
1101111010111101
1100000000010001
111C101011010101
1E111X10000101X1
1011101111110101
1000000000000001
1111111111111111